https://github.com/nwilming/pyedfread 
Some examples for samples:
    time: time stamp of sample
    flags: flags to indicate contents
    px: pupil x, y
    py
    hx: headref x, y
    hy
    pa: pupil size / area
    gx: screen gaze x, y
    gy
    rx: screen pixels per degree
    ry
    status: status flags
    input: extra input word
    buttons: button state & change
    htype: head-tracker data
    hdata: Not included
    errors: process error flags
    gxvel: gaze x,y velocity
    gyvel
    hxvel: headref x,y velocity
    hyvel
    rxvel: raw x, y velocity
    ryvel
    fgxvel: fast gaze x, y velocity
    fgyvel
    fhxvel: fast headref x, y velocity
    fhyvel
    frxvel: fast raw x, y velocity
    fryvel

Some examples for events:
    time - time point where event occured
    type - event type
    eye - eye: 0=left, 1=right
    start - start time
    end - end time
    gavx, gavy - average gaze location
